A,A,X,C,C,C,A,A,A,A
X,A,X,C,X,X,A,X,A,X
X,A,X,C,X,X,N,X,A,X
X,A,N,N,N,X,C,C,C,C
X,A,X,C,N,X,C,X,C,N
C,A,C,C,N,C,N,C,C,N
X,A,X,C,N,N,N,X,A,N
X,A,X,C,X,X,N,X,A,N
X,A,X,C,X,X,A,A,A,N
N,A,X,C,X,X,A,X,A,N